00000000000000000000000000000000000000000000000000000000000000000000000000000000000000000000000000000000000
00000000000000000000000000000000000000000000000000000000000000000000000000000000000000000000000000000000000
00000000000000000000000000000000000000000000000000000000222000000000000000000000000000000000000000000000000
00000000000000000000000000000000000000000000000000000000111000000002222000000000000000000000000000000000000
00000000000000000000000000000000000000000000222200000000111000000001111000000000000000000000000002200000000
00000000000000000000000000000000000000000000111100000000000000000000000000000002222222220000000001100000000
00000000000000000000000000000000022222000000000000000000000000000000000000000001111111110000000000000000022
00000000000000000000000000000000011111000000000000000000000000000000000000000000000000000000000000000000011
00022222220000000022222222000000000000000000000000000000000000000000000000000000000000000000000000000000000
00000000000000000000000000000000000000000000000000000000000000000000000000000000000000000000000022220000000
00000000000000000000000000000000000000000000000000000000000000000000000000000000000000022220000011110000000
00000000000000000000000000000000000000000000000000000000000000000000000000000000000000000000000000000000000
00000000000000000000000000000000002222200000000000000002220000000000000022222222222000000000000000000000000
00000000000000000000000000000000000000000000222222000000000000000000000000000000000000000000000000000000000
00000000000000222222222222222000000000000000000000000000000000000222200000000000000000000000000000000000000