000000000000000000000000000000000000000000000000000000000000
000000000000000000000000000000000000000000000000000000000000
000000000000000000000000000000000000000000000000000000000000
222200000000000000000000000000000000000000000000000000000000
000000000000022220000000000000000000000000000000000022222222
000000000000000000000000000000000000000000000222220000000000
000022000000000000000000000000000000000000000000000000000000
000000000000000000000000000000000222000000000000000000000000
000000000000000000000000000000000000000000000000000000000000
000000000000000000000000022222000000002200000000000000000000
220000000000000000000000000000000000000000000000000000000000
222222222222222222220000000000000000000000000000000000000000